11111111111111111111111111111
10010001000000000100000000CC1
100001110000CC0001000C0000001
1P0CE0010000C0000100000C00001
100001000000000C0000000000001
10001C0000C000000000000000001
100001100000C0000111111100001
100C001CCC000010000C000000001
1000C010000000110000000C00001
1000C000000000011C0C000000001
1000000000CC00001100000CC0001
10111100000000001100000000001
100C00010000C0000000C00000001
10C0000100000000000000000C001
11111111111111111111111111111