11111111111111111111111111111
11011111111111111111111111111
11111111111111111111111111111
1P000000000000000000000000111
11111111111111111111111110111
11111111111111111111111110111
11111111111111111111111110111
11111111111111111111111110111
11111111111111111111111110111
11111111111111111111111110111
11111111111111111111111110111
11111111111111111111111110111
1111111111111111111111111C111
1111111111111111111111111E111
11111111111111111111111111111