1111111111111
1C010C00000C1
10C0000CC0001
1P0011E000C01
1111111111111