1111111111111
1001000000001
10P001110E001
1000000100001
1111111111111