1111111111111
1001000000001
10P0011100001
100C000100001
1111111111111