1111111111111
1001000000001
1000011100001
100CE00100001
1111111111111