1111111111111
1001000000001
10P000E001
1000C00100001
1111111111111