1111111111111
1000000000001
10P000000E001
1000C00000001
1111111111