1111111111111
1001000000001
00P001110E001
1000C00100001
1111111111111