1111111111111
10010000E0001
10P0011100001
100C0E100001
1111111111111